1111111111111
1VV10000000C1
1V00011111001
1P0011E000001
1111111111111